#,#,#,#,#,#,#,#,#,#,
#,.,.,.,.,.,.,.,.,#,
#,.,.,.,.,.,.,.,.,#,
#,.,.,.,.,@,.,.,.,#,
#,#,#,#,#,#,#,#,#,#